6600000000000000000000000000000066
6000500264000000210260000001112006
0000100222000000000000000000000005
0111000462000211102100010100000001
0000000000000000004000100040000001
0000021000000000040001000000010001
4000006101000000000400004100000001
0022006000120200000000000000101001
0000006040062200000040000000000001
0400410000016100000000000041000101
0000000010001600000000000000000001
0066000400000120000006060000000011
0000000000010020000200000200000101
0000000004000010000222222200001001
0010000000010000000000000000010000
0101010001112000000000000000100010
2060210101661100000000000001600000
1211111111661111011300000111501001
1221111111111111611111111111211211
6122222222222222222222222222222216
6611111111111111111111111111111166
