111111111111111111111111111111111
130000000000000000000000000000001
111111111111111111111111111111121
100000000000000000000000000000001
121111111111111111111111111111111
100000000000000000000000000000001
111111111111112111211111111111111
100000000000000000000000000000001
121111111111111211111111111111121
100000000000000000000000000000001
166626666666666666666666666666621
100000000000000000000000000000001
111111121111111111111111122111111
100000020000000000000000001000001
100001020000000000000000012000001
100000020000000000000040002000001
100000020000000000000000011000001
100040020000001000000000402000001
100000020000000000000000022100051
111111111111111111111111111111111