111111111111111111111111111111111
100000000000000000000000000000001
100000000000000000000000000000051
100000000000000000000000000000001
100000000000000000000000000006001
100000000000000000000000000006401
100000000000111111111111111111111
100000000001111111111111111111111
100000000011111111111111111111111
100000000000000000000000000000001
100000000100000000000000000000001
100000000000000000000000000000001
100000001222222222222222222222221
100000011121221212121212121212121
100000111622666666666666666666661
100001111002002002000000000000001
100011111002002002000000000000001
100111111002002002000000221000001
131111111002112112110000211000051
111111111111111111111111111111111