0000000000000000000000000000000000
0000000000000000000000000000000000
0000000000000000000000000000000000
0000000000000000000000000000000000
0000000000000001001000000000100000
0000000000000000000000000000000000
0000000000000040000000000000000000
0000000000000000000400000004000000
0000000000000000000000000000000000
0000000000000400000010000010000000
0000000000000000000000000000000000
0000000000000000000000000000000000
0000000000004000000004000400000000
0000000000000000000000000100000000
0010000000010000000000101111000000
0011010001110000000000000151000000
3000010101111100000000000102000040
1111111111111111222221142111161111
1111111111111111112211111111111111
1111111111111111111111111111111111
1111111111111111111111111111111111
