111111111111111101111111111111111
100000000000020000020000000000001
100000000002225000522200000000001
100001010001111000111100010100001
100000000010100000001010000000001
110100000101000404000101000001011
100000401010000000000010104000001
100000100000000111000000001000001
104011111000001111100000111110401
101000000000000000000000000000101
111100000111110000011111000001111
100000000000000000000000000000001
100000000000000000000000000000001
100040004000004000400000400040001
100000000000000000000000000000001
100001110000000111000000011100001
100010001000001000100000100010001
101110001110111000111011100011101
130000000000000000000000000000001
111111111111111111111111111111111
