666666666666666666666666666666666
632222222222222244464644464644646
602222224644464246466446444464446
612464244464644244444644646444646
662644246446444244644464444446466
612446264444444244444644464444446
642464244464444246464444444644646
642222244444444244444464464444446
644444244444444244644444444644446
644444246444644244444644644446446
644222244444444244464444444444446
644244444444222224444444644646446
644222244444222224444444444444446
644444242222222222222444444464446
644444242444442444442224224444446
642222222444222444422444222222246
642444444444244244222222244444246
642444444444222222224444444442246
644444444444442444444444444445446
644444444444444444444444444444446
