111111111111111111111111111111111
130100000000000066666660000000001
112100000000000066666660000000001
162100000000000060666060000000001
162100000000000060666060000000001
162100000000000066666660000000001
162100000000000060666060000000001
162100000000000060000060000000001
162100000000000066666660000000001
162100000000002222222222222222251
162111112000011111111111111111111
162111112000111111111111111111111
162111112001111111111111111111111
162111112011111111111111111111111
162000000100000000000000000000001
162010101000000000000000000000001
162000000000000000000000000000001
162000002222222222222222222222221
162404046666666666666666666666661
111111111111111111111111111111111
