111111111111111111111111111111111
100000000000000000000000000000001
100000000000000000000000000000001
100000000000000000000000000000001
100000000000000000000000000000001
100000000000000000000000000000001
100000000000000000000000000000001
100000000000000000000000000000001
100000000000000000000000000000001
100000000000000000000000000000001
120000000000000000000000000000001
121000000000000000000000000000001
121100000000000000000000011111211
121110000000000000000000166111211
121111000000003000000001652222211
121111111111111111111111111111111
121111111111111111116666611111111
121111111111111111116222611111111
122222222222222222222222611111111
111111111111111111111111111111111