111111111111111111111111111111111
100000000000000060000000000000001
105060000000100020000220000000001
100000000000010010021111111111001
101040100021100000026000000001121
100010000210004000026211110000031
100000002101000010020222100111111
100000021001040020020222104000001
100000210000000020020122261600001
100002160000411111110012262000001
111100006000000000002011202222161
100001000600000000066601011112211
100010100060000000065600100001221
100100010001000000066600000000121
102000201600600000000000012100060
162000106000060000010000000010052
102000022200000021000001400001102
121004011100000110000100021000201
166000006010000260000646660200241
111111111111111111111111111111111